########################
##########X     ########
########## B###  X######
#########  BP  B  ######
#########     B   ######
#########X     X########
#######LEVEL0###########