####################
############    ####
###X     B     B X##
#########   P  B X##
#########X  B     ##
####################
#######LEVEL0#######