########################
###     ####    ########
###X   B##     B  X#####
###X        P     X#####
#####B  #     B   ######
####             #######
#######LEVEL1###########